size:
11,11
layer_0:
24444144442
24444144442
24444144442
24444144442
24444144442
24444144442
22444144422
22222122222
32321112323
33333133333
33333133333
layer_1:
00000000000
00000000000
00000000000
00000000000
00000000000
00000000000
00000000000
00000000000
00000000000
00000000000
00000000000
monster:
2
9,5,1
8,5,2
npc:
0
item:
0
portal:
1
10,5,up,1,0,5