size:
11,11
layer_0:
00000100000
00000100000
00000100000
00000100000
00000100000
00000100000
00000100000
00000100000
00001110000
00000100000
00000100000
layer_1:
24444044442
24444044442
24444044442
24444044442
24444044442
24444044442
22444044422
22222022222
32320002323
33333033333
33333033333
monster:
2
9,5,1
8,5,2
npc:
0
item:
0
portal:
1
10,5,up,level1,5,1