size:
11,11
layer_0:
24411111442
24441114442
24444144442
24444144442
24444144442
24444144442
22444144422
22222122222
32321112323
33333133333
33333133333
layer_1:
00000000000
00000000000
00000000000
00000000000
00000000000
00000000000
00000000000
00000000000
00000000000
00000000000
00000000000
monster:
1
6,5,1
npc:
0
item:
0
portal:
1
7,5,down,0,1,5