size:
11,11
layer_0:
01111111111
22222222221
111Y1211121
11121211121
2Y221222121
11121Y11121
11121222221
2Y221111111
11122R222Y2
11121112111
11121012111
layer_1:
00000000000
00000000000
00000000000
00000000000
00000000000
00000000000
00000000000
00000000000
00000000000
00000000000
00000000000
monster:
9
2,1,5
5,1,5
7,1,1
8,2,1
1,9,8
5,6,6
5,7,7
5,8,2
6,8,4
npc:
0
item:
0
portal:
2
0,5,down,0,1,5
10,0,up,2,1,5